############################
#                          #
# ########## ## ########## #
# ########## ## ########## #
#      ##    ##    ##      #
### ## ## ######## ## ## ###
### ## ## ######## ## ## ###
#   ##                ##   #
# #### ##### ## ##### #### #
# #### ##### ## ##### #### #
#            ##            #
###### ## ######## ## ######
###### ## ######## ## ######
     # ##          ## #     
     # ## ###-#### ## #
###### ## #      # ## ######
          #      #          
###### ## #      # ## ######
###### ## ######## ## ######
     # ##          ## #     
     # ##### ## ##### #     
###### ##### ## ##### ######
#      ##    ##    ##      #
# #### ## ######## ## #### #
# #### ## ######## ## #### #
#                          #
# #### ##### ## ##### #### #
# #  # #   # ## #   # #  # #
# #### ##### ## ##### #### #
#            ##            #
############################