{
    "width": 28,
    "height": 31,
    "str_array": [
        "############################",
        "#                          #",
        "# ########## ## ########## #",
        "# ########## ## ########## #",
        "#      ##    ##    ##      #",
        "### ## ## ######## ## ## ###",
        "### ## ## ######## ## ## ###",
        "#   ##                ##   #",
        "# #### ##### ## ##### #### #",
        "# #### ##### ## ##### #### #",
        "#            ##            #",
        "###### ## ######## ## ######",
        "###### ## ######## ## ######",
        "     # ##          ## #     ",
        "     # ## ###-#### ## #     ",
        "###### ## #      # ## ######",
        "          #      #          ",
        "###### ## #      # ## ######",
        "###### ## ######## ## ######",
        "     # ##          ## #     ",
        "     # ##### ## ##### #     ",
        "###### ##### ## ##### ######",
        "#      ##    ##    ##      #",
        "# #### ## ######## ## #### #",
        "# #### ## ######## ## #### #",
        "#                          #",
        "# #### ##### ## ##### #### #",
        "# #  # #   # ## #   # #  # #",
        "# #### ##### ## ##### #### #",
        "#            ##            #",
        "############################"
    ]
}
